9 20
8 10
0 9
__7__7___7_7__7____7
|7||7||_77|*|_|_7|_|
|||||*|||*|*__7||_|7
|*||*7_7*7*__7*||*_|
*77*|*||_|__7*7_|__|
_**__7_||*||*__*_*_7
|*7*7|*_7_|__*7__7_|
__|_|*_7*7||__|*7**7
*_7|__7*7*7|*7_7*__7
